  F     D         E   D       
ZZZZZZZZHZZZZZZZZZZZZZHZZZZZZZ
        H             H       
        H             H       
        H             H       
        H             H       
        S      D      S       
        ZZZZZZZHZZZZZZZ       
               H              
               H              
   E   D       S          D   
ZZZZZZZHZZZZZZZZZZZZZZZZZZHZZZ
       H                  H   
       H                  H   
  D    S          E    D  S   
ZZHZZZZZZZZZZZ   ZZZZZZHZZZ   
  H                    H      
  H                    H      
  S                D   S    E 
ZZZZZZZZZZZZZZZZZZZHZZZZZZZZZZ
                   H          
                   H          
                   H          
                   H          
       E           S     D    
ZZZZZZZZZZZZZZZZZZZZZZZZZHZZZZ
                         H    
                         H    
                         S  P 
ZZZZZZZZZZZZZZZZZZZZZZZZZZZZZZ