  F     D             D       
ZZZZZZZZHZZZZZZZZZZZZZHZZZZZZZ
        H             H       
        H             H       
        H             H       
        H             H       
        S  E   D      S       
        ZZZZZZZHZZZZZZZ       
               H              
               H              
    D  E       S          D   
ZZZZHZZZZZZZZZZZZZZZZZZZZZHZZZ
    H                     H   
    H                     H   
 E  S     D       E    D  S   
ZZZZZZZZZZHZZZ   ZZZZZZHZZZ   
          H            H      
          H            H      
D         S     D      S    E 
HZZZZZZZZZZ    ZHZZZZZZZZZZZZZ
H               H             
H               H             
S  E   D        S             
ZZZZZZZHZZZZZZZZZ             
       S          E      D    
ZZZZZZZZZZZZZZZZZZZZZZZZZHZZZZ
                         H    
                         H    
                         S  P 
ZZZZZZZZZZZZZZZZZZZZZZZZZZZZZZ